# HaverQuest Map Level 1
# G -- Grass
# B -- Grey brick
# R -- Red brick
# Unsolvable in some circumstances
GGGGGGGGGGRGGGGGGGGG
GGGGGGGGGGRGGGGGGGGG
GGGGGGGGGGRGGGGGGGGG
GGGGGGGGGGRRRRRRRRRR
GGGGGGGGGGGGGGGGGGGG
GGGGGGGGGGGGGGGGGGGG
GGGGGGGGGGGGGGGGGGGG
GGGGGGGGGGGGGGGGGGGG
GGGGGGGGGGGGGGGGGGGG
GGGGGGGGGGGGGGGGGGGG
GGGGGGGGGGGGGGGGGGGG
GGGGGGGGGGGGGGGGGGGG
BBBBBGGGGGGGGGGGGGGG
GGGRGGGGGGGGGGGGGGGG
GGGRGGGGGGGGGGGGGGGG
GGGRGGGGGGGGGGGGGGGG
GGGRGGGGGGGGGGGGGGGG
GGGRGGGGGGGGGGGGGGGG
GGGRGGGGGGGGGGGGGGGG
GGGRGGGGGGGGGGGGGGGG
